chõ	cho
senõ	seño
trraͣ	tierra
c̀	cri
õ	on
ũ	un
ỹ	y
ẽ	en
ã	an
j̃	in
ĩ	in
dł	del
eñl	en el
	ser
ꝟ	ver
ñs	nes
ns̃	nes
r̃s	res
s̃ 	es 
ñgaͣ	ninguna
q̀	qui
p̀	pri
ꝑa	para
enꝑa	enpera
ꝑ	per
łło	llero
łlo	llero
łłia	lleria
ẻ	er
aᷤ	as
oᷤ	os
naͣ	nera
p̊	pro
x̃	cri
d̃	de
pͤ	pre
q̃	que
qͣ	qua
